11111111111111111111
1E0000000000000C0001
10100101001000001001
10100100101010100001
100000001C00C0000001
10000000100000000001
11111111111111111111
