111111111111111
1E0000000000001
1010010000C0001
100000000000001
111001001110111
100000001C00C01
1P0000001000001
111111111111111
